

*****************************************
*                                       *
*           Inventory  Report           *
*                                       *
*****************************************
 Item Type  Item Description  Power Level
*****************************************
